|
0000000000000000000000000000
0000000000000000000000000000
00AAAAAA0BBB0CCCCC0DDDDDDD00
00AAAAAA0BBB0CCCCC0DDDDDDD00
00AAAAAA0BBB0CCCCC0DDDDDDD00
00AAAAAA0BBB0CCCCC0DDDDDDD00
00AAAAAA0BBB0CCCCC0DDDDDDD00
00AAAAAA0BBB0CCCCC0DDDDDDD00
00AAAAAA0BBB0CCCCC0DDDDDDD00
0000PP000BBB0CCCCC0DDDDDDD00
00EEEEEE0BBB00PP00000PP00000
00EEEEEE0BBBBBBBBBBBBBBBBB00
00EEEEEE0BBBBBBBBBBBBBBBBB00
00EEEEEEPBBBBBBBBBBBBBBBBB00
00EEEEEEPBBBBBBBBBBBBBBBBB00
00EEEEEE0BBBBBBBBBBBBBBBBB00
00EEEEEE0BBBBBBBBBBBBBBBBB00
00EEEEEE0BBBBBBBBBBBBBBBBB00
0000000000000000000000000000
0000000000000000000000000000
|
1111111111111111111111111111
1111111111111111111111111111
1166666616661666661666666611
1166666616661666661666666611
1166666616661666661666666611
1166666616661666661666666611
1166666616661666661666666611
1166666616661666661666666611
1166666616661666661666666611
1111661116661666661666666611
1166666616661166111116611111
1166666616666666666666666611
1166666616666666666666666611
1166666666666666666666666611
1166666666666666666666666611
1166666616666666666666666611
1166666616666666666666666611
1166666616666666666666666611
1111111111111111111111111111
1111111111111111111111111111
o1a4:2
o2a21:2
oCb16:14
f19:10
d4:9>AE
d5:9>AE
td9:2
tu11:2
r1:1
=