|
0000000000000000000000000000
0000000000000000000000000000
0011111102220333330444444400
0011111102220333330444444400
0011111102220333330444444400
0011111102220333330444444400
0011111102220333330444444400
0011111102220333330444444400
0011111102220333330444444400
0000PP0002220333330444444400
00555555022200PP00000PP00000
0055555502222222222222222200
0055555502222222222222222200
00555555P2222222222222222200
00555555P2222222222222222200
0055555502222222222222222200
0055555502222222222222222200
0055555502222222222222222200
0000000000000000000000000000
0000000000000000000000000000
|
1111111111111111111111111111
1111111111111111111111111111
1166666616661666661666666611
1166666616661666661666666611
1166666616661666661666666611
1166666616661666661666666611
1166666616661666661666666611
1166666616661666661666666611
1166666616661666661666666611
1111661116661666661666666611
1166666616661166111116611111
1166666616666666666666666611
1166666616666666666666666611
1166666666666666666666666611
1166666666666666666666666611
1166666616666666666666666611
1166666616666666666666666611
1166666616666666666666666611
1111111111111111111111111111
1111111111111111111111111111
o1a4:2
o2a21:2
o3b16:14
f19:10
d4:9
d5:9
td9:2
tu11:2
r1:1
=