1111111111111111111111111111
1111111111111111111111111111
1166666616661666661666666611
1166666616661666661666666611
1166666616661666661666666611
1166666616661666661666666611
1166666616661666661666666611
1166666616661666661666666611
1166666616661666661666666611
1111661116661666661666666611
1166666616661166111116611111
1166666616666666666666666611
1166666616666666666666666611
1166666616666666666666666611
1166666666666666666666666611
1166666616666666666666666611
1166666616666666666666666611
1166666616666666666666666611
1111111111111111111111111111
1111111111111111111111111111
=
1111111111111111111111111111
1111111111111111111111111111
1166666616661666661666666611
1166666616661666661666666611
1166666616661666661666666611
1166666616661666661666666611
1166666616661666661666666611
1166666616661666661666666611
1166666616661666661666666611
1111161116661666661666666611
1166666616661116111111611111
1166666616666666666666666611
1166666616666666666666666611
1166666616666666666666666611
1166666666666666666666666611
1166666616666666666666666611
1166666616666666666666666611
1166666616666666666666666611
1111111111111111111111111111
1111111111111111111111111111
