1111111111111111111111111111
1111111111111111111111111111
1166666616661666661666666611
1166666616661666661666666611
1166666616661666661666666611
1166666616661666661666666611
1166666616661666661666666611
1166666616661666661666666611
1166666616661666661666666611
1111661116661666661666666611
1166666616661166111116611111
1166666616666666666666666611
1166666616666666666666666611
1166666666666666666666666611
1166666666666666666666666611
1166666616666666666666666611
1166666616666666666666666611
1166666616666666666666666611
1111111111111111111111111111
1111111111111111111111111111
o1a4:2
o2a21:2
o3b16:14
f190:10
d15:10
d26:11
t114:40
t216:41
r1:1
r2:
r3:
=
1111111111111111111111111111
1111111111111111111111111111
1166666616661666661666666611
1166666616661666661666666611
1166666616661666661666666611
1166666616661666661666666611
1166666616661666661666666611
1166666616661666661666666611
1166666616661666661666666611
1111161116661666661666666611
1166666616661116111111611111
1166666616666666666666666611
1166666616666666666666666611
1166666616666666666666666611
1166666666666666666666666611
1166666616666666666666666611
1166666616666666666666666611
1166666616666666666666666611
1111111111111111111111111111
1111111111111111111111111111
